双流区	某个区或者地点
徐汇区	某个区或者地点
你问的这么详细做什么	你问的这么详细做什么
你问这么详细做什么	你问的这么详细做什么
你问的这么详细干什么	你问的这么详细做什么
你问这么详细干什么	你问的这么详细做什么
问的这么详细做什么	你问的这么详细做什么
问这么详细做什么	你问的这么详细做什么
问的这么详细干什么	你问的这么详细做什么
问这么详细干什么	你问的这么详细做什么
胜利家园	楼盘名小区名
梓树园	楼盘名小区名
罗山新村	楼盘名小区名
钦州路111弄	楼盘名小区名
康健路100弄	楼盘名小区名
科园新村	楼盘名小区名
明年5月份	交房时间
今年夏天	交房时间
4月份	交房时间
4月4日	交房时间
80平米	建筑面积
90平米	建筑面积
100平米	建筑面积
125平	建筑面积
70平	建筑面积
三室一厅	户型
2室1厅	户型
3室2厅	户型
3室1厅	户型
简约	装修风格
豪华	装修风格
田园	装修风格
欧式	装修风格
清新	装修风格
暂时没有了	暂时没有了
其他没有了	暂时没有了
没别的了	暂时没有了
就这样吧	暂时没有了
不方便接听电话	不方便接听电话需微信联系
需微信联系	不方便接听电话需微信联系
现在不方便接听电话	不方便接听电话需微信联系
请微信联系	不方便接听电话需微信联系
我现在不方便接听电话	不方便接听电话需微信联系
发短信	不方便接听电话需微信联系
短信联系	不方便接听电话需微信联系
可以添加手机号	可以添加手机号
可以	可以添加手机号
可以的	可以添加手机号
手机号码	可以添加手机号
可以添加手机号码	可以添加手机号